NO       ./textures/dog_freeze.xpm   
SO ./textures/dog_king.xpm  
WE ./textures/dog_rhalouf.xpm
EA             ./textures/dog_electric.xpm
C                                   225,30,0     
F 320, 100   , 1


111111111111
100000000001
100000000001
100000000001
100000000001111111111111111111111111111111111111111111111111111111
1000000000000000000000000000000000000000000000000000000000000000011111
11111111111000000000000000000000000000000000000000000000000000000000011
          11E0000000000000000000000000000000000000000000000000000000001
          1100000000000000000000000000000000000000000000000000000000001
11111111111000000000000000000000000000000000000000000000000000000000011
1000000000000000000000000000000000000000000000000000000000000000011111
100000000001111111111111111111111111111111111111111111111111111111
100000000001
100000000001
100000000001
111111111111


